
C  1,0,0
NO 		./img/jiggly.xpm		
F			70,0,0
SO					./img/gengar.xpm
	WE 	 	./img/mewtwo.xpm
EA ./img/charizard.xpm


11111111111111111111111
100011111111111111111111
10110000011100000000001111
100100000000000000000001111111111
11111111101100000111000000000001
100000000011000001110111111111111
10110111111111011100001000111
10110111111111011101010010001
10111111111111111101110111111
101              101 111
101              101  1                 1111111111111111111
101              101                    1000000000000000001
101              101111111111111111111111100000000000000001
101              100000000000000000000000000000000000000001
101              111111111111111111111111000000000000000001
101                                     1000000000000000001
101                                     1000000000000000001
101                                     1000000000000000001
101                                     1000000000000000001
101                                     10000000000000000E1
111                                     111111111111111111