NO 		./img/NO_OLIVES.xpm		
SO							./img/NO_OLIVES.xpm
	WE 	 	./img/NO_OLIVES.xpm
EA ./img/NO_OLIVES.xpm
F			254,100,0
C 111,10,0


11111111111111111111111111
 1  11111   1111111111
1011000001110000E000001111
10010000000000000000000111111111
111111111011000001110000000000001
100000000011000001110111111111111
11110111111111011100001000111
11110111111111011101010010001
11111111111111111111111111111