NO 		./img/Black.xpm		
SO							./img/NO_OLIVES.xpm
	WE 	 	./img/Purple.xpm
EA ./img/Yellow.xpm
F			254,100,0
C 111,10,0


11111111111111111111111111
 1  11111   1111111111
10110000011100000000001111
10010000000000000000000111111111
111111111011000001110000000000001
100000000011000001110111111111111
10110111111111011100001000111
10110111111111011101010010001
10111111111111111111111111111
101 
101                                     1111111111111111111
101                                     1000000000000000001
101                                     1000000000000000001
101                                     1000000000000000001
101                                     1000000000000000001
101                                     1000000000000000001
101                                     1000000000000000001
101                                     1000000000000000001
101                                     1000000000000000001
1S1                                     1000000000000000001
111                                     1111111111111111111